C 200,20 ,30
R 234454554 1134256142545
NO ./textures/NO.xpm
SO ./textures/SO.xpm
EA ./textures/EA.xpm
WE ./textures/WE.xpm

S ./textures/S.xpm

F  000, 000, 00



111111111111111111111111111111
111111111000200000000000011111
100000000000000000111000100001
110000100000000000000000001111
100001111111000000020000111111
111111100000000W00000000000001
111100000000001100000002000011
1                            1
1                            1
110000000000011110000000000011
100000000000111000000000000011
110000000000111000000000001111
110000000001111000000000000111
111111111111111111111111111111


